Attacking Android - Looking good 
Attacking iOS 
Appsec - More 
Building a Pen Test Lab 
Computer Hardware attacks - General 
Con Videos - Add Defcon Archive; Shmoocon/Ruxcon/etc. 
Counter Surveillance - Need Legit info 
Crypto Currencies 
Crypto - General/form 
CTFs & Wargames 
Darknets - Need more than just reddit 
Data Visualization - More in general 
Disinformation - Needs more info, bare 
Disclosure - Some historical things 
Documentation & Reporting 
Embedded Devie Security - Combine with Hardware Hacking 
Exploit Dev - Structure/cleanup/clear out 
Forensics - Integrate from cull list; More anti-forensics; more resources 
Fuzzing - Educational stuff; more writeups 
[Game Hacking] 
Google Hacking - Completely empty 
Hardware Hacking - Combine with Embedded Device 
Honeypots - More 
Lockpicking - needs more 
Logging - More for all 
Malware - Structure, clean out cull 
Network Attacks and Defense - Structure, clean out cull, add more 
Network Recon - More in general, more finesse 
Network Security Monitoring - more in general 
OSINT - Looking better - Need to clear cull folder 
Passwords - Clean out cull/structure/more 
Phishing Under Client Side Attacks 
Persistence - Needs some lovin 
Privilege Escalation and Post-Exploitation - Cleanup/Structure 
Programming - Some stuff 
Pwning Skiddies - meh/Needs more 
Reverse Engineering - Structure/clean out cull/more 
Rootkits - Needs more/Structure 
Securing & Hardening - Structure/simplify 
Social Engineering - Could do with a touch up) 
SDR - needs work 
SysInternals - Always use more 
Tor - Needs mo 
Threat Modeling - Needs more 
UX/Design(because we all know pgp is sexy) - Could do with a few more links 
Sysadmin - Always more 
WebApp - Structure/cleanup/clear out cull 
Wireless Networks- More info/structure